Provincia,Año,Trimestre,ADSL,Cablemodem,Fibra óptica,Wireless,Total,Mbps (Media de bajada),Tasa de Crecimiento
Buenos Aires,2022,4,325908,2767247,1499149,129910,4722214,111.0,1.58
Capital Federal,2022,4,138753,1238196,138548,4603,1520100,182.9,1.81
Catamarca,2022,4,8952,10998,47337,1379,68666,83.3,1.37
Chaco,2022,4,24582,61265,47285,7957,141089,104.0,1.95
Chubut,2022,4,45450,73923,9815,30721,159909,15.92,1.02
Córdoba,2022,4,152265,456947,367393,61631,1038236,108.75,1.93
Corrientes,2022,4,34038,80283,26752,9082,150155,94.75,2.1
Entre Ríos,2022,4,55507,135746,40798,26414,258465,87.5,2.06
Formosa,2022,4,13735,17068,13118,17692,61613,72.0,2.37
Jujuy,2022,4,17880,52390,42626,4067,116963,39.3,1.21
La Pampa,2022,4,7785,60566,24552,19995,112898,19.1,1.06
La Rioja,2022,4,6120,54387,19328,6395,86230,61.0,1.38
Mendoza,2022,4,37655,77814,147080,27607,290156,38.75,1.13
Misiones,2022,4,33204,87202,46885,11075,178366,91.25,1.85
Neuquén,2022,4,28609,72679,31567,23815,156670,95.4,1.99
Río Negro,2022,4,34043,48401,43958,16277,142679,75.3,2.21
Salta,2022,4,36939,97023,53470,11884,199316,75.94,1.84
San Juan,2022,4,38570,22913,12491,21912,95886,16.39,1.03
San Luis,2022,4,6283,43460,3409,81557,134709,30.67,1.59
Santa Cruz,2022,4,9702,23876,12217,3746,49541,14.33,1.14
Santa Fe,2022,4,163621,412157,248558,44113,868449,90.3,2.0
Santiago Del Estero,2022,4,13577,80955,15117,6911,116560,34.4,1.94
Tierra Del Fuego,2022,4,12754,41293,405,157,54609,13.48,1.22
Tucumán,2022,4,69441,20668,168717,4069,262895,88.3,1.66
Buenos Aires,2022,3,339648,2748325,1436433,126846,4651252,70.2,1.07
Capital Federal,2022,3,140791,1240125,129218,5758,1515892,101.06,1.08
Catamarca,2022,3,10010,10495,46224,1329,68058,61.0,1.08
Chaco,2022,3,27164,61800,44645,8178,141787,53.22,1.05
Chubut,2022,3,45377,72212,9574,29784,156947,15.57,1.04
Córdoba,2022,3,163770,465461,338570,61070,1028871,56.3,1.05
Corrientes,2022,3,36508,77140,18619,7256,139523,45.06,1.04
Entre Ríos,2022,3,60345,132952,36971,26098,256366,42.5,1.06
Formosa,2022,3,14470,25880,11041,16935,68326,30.34,1.07
Jujuy,2022,3,19257,52978,40172,4033,116440,32.44,1.1
La Pampa,2022,3,7796,60078,23551,20216,111641,18.1,1.13
La Rioja,2022,3,6842,53899,19697,6395,86833,44.3,1.02
Mendoza,2022,3,37659,78858,142615,27625,286757,34.16,1.15
Misiones,2022,3,35513,88902,39046,11074,174535,49.3,1.07
Neuquén,2022,3,29352,75815,29396,27482,162045,47.8,1.03
Río Negro,2022,3,35552,48260,41017,16760,141589,34.12,1.03
Salta,2022,3,40006,96984,50254,10082,197326,41.34,1.07
San Juan,2022,3,38570,22723,12328,21860,95481,15.84,1.1
San Luis,2022,3,6860,29363,248,70614,107085,19.33,1.0
Santa Cruz,2022,3,10170,24047,10815,3896,48928,12.6,1.07
Santa Fe,2022,3,183740,426255,215189,43079,868263,45.16,1.07
Santiago Del Estero,2022,3,15385,80937,13170,6618,116110,17.69,1.08
Tierra Del Fuego,2022,3,12754,39963,403,125,53245,11.01,1.0
Tucumán,2022,3,77738,18518,162345,3997,262598,53.38,1.07
Buenos Aires,2022,2,350652,2719613,1399043,126847,4596155,65.5,1.05
Capital Federal,2022,2,145491,1232226,121506,5757,1504980,94.0,1.07
Catamarca,2022,2,11928,9430,42087,1329,64774,56.56,1.1
Chaco,2022,2,29552,61284,42194,8178,141208,50.62,1.1
Chubut,2022,2,45377,69242,9574,29784,153977,14.91,1.11
Córdoba,2022,2,179181,467595,308895,61107,1016778,53.5,1.07
Corrientes,2022,2,38468,75769,18181,7256,139674,43.3,1.14
Entre Ríos,2022,2,63794,131029,35839,26098,256760,40.03,1.12
Formosa,2022,2,15397,25487,9875,16910,67669,28.47,0.94
Jujuy,2022,2,20303,54495,34184,3955,112937,29.39,1.06
La Pampa,2022,2,7796,59273,22994,20200,110263,16.06,1.08
La Rioja,2022,2,7759,52656,19189,6395,85999,43.28,1.05
Mendoza,2022,2,37663,77504,135504,26964,277635,29.72,1.13
Misiones,2022,2,37208,89260,33649,11074,171191,46.22,1.1
Neuquén,2022,2,29749,74905,28824,27371,160849,46.53,1.08
Río Negro,2022,2,36050,47040,40946,16760,140796,33.25,1.07
Salta,2022,2,42665,96178,47076,10068,195987,38.78,1.06
San Juan,2022,2,38570,19734,12328,21859,92491,14.44,1.2
San Luis,2022,2,6860,29034,248,70614,106756,19.31,0.92
Santa Cruz,2022,2,10170,23725,10815,3896,48606,11.81,1.08
Santa Fe,2022,2,198492,428233,189503,43081,859309,42.0,1.08
Santiago Del Estero,2022,2,16561,80338,11605,6618,115122,16.34,1.13
Tierra Del Fuego,2022,2,12754,39837,403,125,53119,10.97,1.02
Tucumán,2022,2,85893,15327,148823,3997,254040,50.1,1.06
Buenos Aires,2022,1,392045,2728865,1242121,125521,4488552,62.5,1.04
Capital Federal,2022,1,102290,1217225,62308,5784,1387607,88.25,1.06
Catamarca,2022,1,14181,15517,29118,1328,60144,51.22,1.1
Chaco,2022,1,32391,64546,36662,8164,141763,45.84,1.08
Chubut,2022,1,44133,66667,9184,30592,150576,13.4,1.48
Córdoba,2022,1,195610,501799,235838,60843,994090,49.88,1.08
Corrientes,2022,1,40462,79093,10875,6774,137204,38.12,1.07
Entre Ríos,2022,1,67159,138986,23091,26098,255334,35.6,1.07
Formosa,2022,1,16397,15927,5146,16876,54346,30.28,1.05
Jujuy,2022,1,21307,60616,25949,4662,112534,27.69,1.02
La Pampa,2022,1,8003,58978,21739,19903,108623,14.84,1.07
La Rioja,2022,1,9103,59228,9546,6395,84272,41.38,1.04
Mendoza,2022,1,49464,74145,123228,26969,273806,26.2,1.18
Misiones,2022,1,39147,91752,25178,7807,163884,41.88,1.08
Neuquén,2022,1,28443,73200,24193,23098,148934,43.06,1.07
Río Negro,2022,1,38662,45366,38037,16815,138880,31.1,1.14
Salta,2022,1,44714,98667,40994,5950,190325,36.72,1.08
San Juan,2022,1,34038,14449,11294,20723,80504,11.99,1.09
San Luis,2022,1,7987,11296,31,71809,91123,20.95,1.0
Santa Cruz,2022,1,10537,23420,10766,3974,48697,10.89,1.21
Santa Fe,2022,1,213486,444609,146552,45261,849908,38.88,1.08
Santiago Del Estero,2022,1,18118,87979,1093,6349,113539,14.5,1.05
Tierra Del Fuego,2022,1,13031,38700,416,124,52271,10.73,1.0
Tucumán,2022,1,92532,62396,86174,3995,245097,47.25,1.05
Buenos Aires,2021,4,426325,2706506,1176024,126887,4435742,60.22,1.07
Capital Federal,2021,4,111360,1205128,60005,5679,1382172,82.94,1.07
Catamarca,2021,4,16385,13858,25100,1512,56855,46.38,1.07
Chaco,2021,4,35548,63145,34688,8005,141386,42.34,1.08
Chubut,2021,4,46361,57412,9655,28041,141469,9.08,1.11
Córdoba,2021,4,212011,487489,217214,61277,977991,46.38,1.11
Corrientes,2021,4,42523,71183,10138,6778,130622,35.78,1.11
Entre Ríos,2021,4,70459,133387,23452,25022,252320,33.3,1.13
Formosa,2021,4,17211,15111,5151,16018,53491,28.77,1.08
Jujuy,2021,4,22330,60511,24156,2927,109924,27.14,1.04
La Pampa,2021,4,8175,58000,20192,19286,105653,13.85,1.07
La Rioja,2021,4,10387,56651,9446,6613,83097,39.7,1.02
Mendoza,2021,4,59842,71553,109667,24666,265728,22.23,1.66
Misiones,2021,4,41778,92068,22035,7649,163530,38.9,1.26
Neuquén,2021,4,29175,72761,23253,21531,146720,40.1,1.05
Río Negro,2021,4,42037,44495,32212,16558,135302,27.2,1.07
Salta,2021,4,46972,99808,39555,5882,192217,33.94,1.09
San Juan,2021,4,35868,13102,11072,11423,71465,11.05,1.57
San Luis,2021,4,8472,11064,30,70560,90126,20.9,0.96
Santa Cruz,2021,4,10790,22902,10031,4346,48069,8.99,1.17
Santa Fe,2021,4,233427,444373,128856,43556,850212,36.03,1.09
Santiago Del Estero,2021,4,19032,86563,1088,6256,112939,13.84,1.04
Tierra Del Fuego,2021,4,13317,38148,426,124,52015,10.7,1.12
Tucumán,2021,4,97830,59022,78790,2511,238153,45.16,1.07
Buenos Aires,2021,3,585729,2595485,885613,120228,4187055,56.25,1.07
Capital Federal,2021,3,142902,1192107,42966,6059,1384034,77.7,1.07
Catamarca,2021,3,18413,11709,22331,1568,54021,43.44,1.03
Chaco,2021,3,38258,63659,27583,8018,137518,39.12,1.05
Chubut,2021,3,49269,55794,8946,23376,137385,8.18,1.07
Córdoba,2021,3,229275,477223,167495,57617,931610,41.94,1.06
Corrientes,2021,3,44805,69403,7542,6766,128516,32.16,1.06
Entre Ríos,2021,3,74443,128752,20485,23500,247180,29.6,1.07
Formosa,2021,3,18093,14111,4730,15690,52624,26.69,1.11
Jujuy,2021,3,23554,60758,19926,2952,107190,25.98,1.01
La Pampa,2021,3,9015,57881,17817,14479,99192,12.99,1.06
La Rioja,2021,3,11329,54744,9444,6613,82130,38.88,1.01
Mendoza,2021,3,91474,71247,70579,21811,255111,13.37,0.99
Misiones,2021,3,43230,89469,10969,7198,150866,30.88,1.08
Neuquén,2021,3,29650,73794,16455,19270,139169,38.34,1.06
Río Negro,2021,3,47934,44519,18725,15031,126209,25.4,1.07
Salta,2021,3,49212,98318,36126,5724,189380,31.2,1.07
San Juan,2021,3,40072,12922,6670,11372,71036,7.04,1.01
San Luis,2021,3,8417,11884,27,68856,89184,21.7,1.0
Santa Cruz,2021,3,12347,22961,6328,4269,45905,7.69,1.01
Santa Fe,2021,3,245929,443156,93412,43447,825944,33.12,1.08
Santiago Del Estero,2021,3,19939,85535,909,6147,112530,13.35,1.05
Tierra Del Fuego,2021,3,12853,36958,6,16,49833,9.52,1.11
Tucumán,2021,3,104489,53868,70964,2408,231729,42.1,1.04
Buenos Aires,2021,2,603255,2503830,854173,113546,4074804,52.75,1.04
Capital Federal,2021,2,148989,1175097,41318,5580,1370984,72.75,1.07
Catamarca,2021,2,20305,9426,22331,1449,53511,42.2,1.06
Chaco,2021,2,39826,62948,27584,8018,138376,37.4,1.11
Chubut,2021,2,49271,41497,6081,23682,120531,7.68,1.02
Córdoba,2021,2,239780,467782,151855,55944,915361,39.6,1.09
Corrientes,2021,2,46648,67262,3731,6557,124198,30.38,1.17
Entre Ríos,2021,2,77836,124957,17856,23786,244435,27.62,1.16
Formosa,2021,2,19571,12509,3610,15690,51380,23.97,1.14
Jujuy,2021,2,24738,60800,19611,2731,107880,25.81,0.96
La Pampa,2021,2,9017,57014,17132,13209,96372,12.28,1.14
La Rioja,2021,2,11627,54255,9445,6245,81572,38.53,3.03
Mendoza,2021,2,91503,70834,44696,21811,228844,13.47,1.07
Misiones,2021,2,44960,87861,10376,5317,148514,28.69,1.14
Neuquén,2021,2,30083,72690,15619,19218,137610,36.12,1.05
Río Negro,2021,2,48189,43761,18727,15031,125708,23.75,1.08
Salta,2021,2,51396,96016,32050,5724,185186,29.23,1.07
San Juan,2021,2,40072,12369,6673,11372,70486,6.99,1.01
San Luis,2021,2,8417,11308,28,66860,86613,21.66,1.0
Santa Cruz,2021,2,12347,22967,6328,4269,45911,7.63,1.02
Santa Fe,2021,2,256741,431915,90424,43997,823077,30.7,1.09
Santiago Del Estero,2021,2,20734,83770,909,5081,110494,12.72,1.1
Tierra Del Fuego,2021,2,12853,22504,6,14,35377,8.59,0.98
Tucumán,2021,2,110429,48359,71683,1837,232308,40.3,1.06
Buenos Aires,2021,1,629679,2452056,821597,98806,4002138,50.78,1.02
Capital Federal,2021,1,159805,1145093,39980,5559,1350437,68.3,1.01
Catamarca,2021,1,26316,4409,18688,322,49735,39.97,1.06
Chaco,2021,1,43214,61251,25426,8004,137895,33.62,1.04
Chubut,2021,1,45501,40960,3444,23723,113628,7.53,1.02
Córdoba,2021,1,260350,444695,134634,54137,893816,36.16,1.03
Corrientes,2021,1,49160,62876,3337,5949,121322,25.98,1.02
Entre Ríos,2021,1,83688,118424,16846,20836,239794,23.88,0.99
Formosa,2021,1,20663,11412,2562,15669,50306,20.98,1.06
Jujuy,2021,1,32254,54324,17322,2677,106577,26.78,1.06
La Pampa,2021,1,8946,58711,15779,12369,95805,10.73,1.09
La Rioja,2021,1,17363,34984,1,250,52598,12.7,1.01
Mendoza,2021,1,91844,69295,38619,18332,218090,12.6,1.14
Misiones,2021,1,48292,82339,7064,4796,142491,25.08,1.0
Neuquén,2021,1,30223,70457,14171,17752,132603,34.25,1.01
Río Negro,2021,1,48777,42192,17828,13994,122791,21.92,1.01
Salta,2021,1,54768,89187,31498,5669,181122,27.31,1.08
San Juan,2021,1,40072,11589,6671,11482,69814,6.91,1.08
San Luis,2021,1,8417,10678,28,63826,82949,21.6,1.02
Santa Cruz,2021,1,12347,23089,5975,4264,45675,7.5,1.0
Santa Fe,2021,1,277012,421480,70976,39140,808608,28.12,1.03
Santiago Del Estero,2021,1,26468,75849,570,5158,108045,11.58,1.03
Tierra Del Fuego,2021,1,12853,27247,6,0,40106,8.73,1.03
Tucumán,2021,1,147199,12185,69954,1834,231172,37.97,1.04
Buenos Aires,2020,4,635651,2441248,804991,93444,3975334,50.0,1.03
Capital Federal,2020,4,163060,1142528,39890,4815,1350293,67.3,1.06
Catamarca,2020,4,26870,5115,17856,322,50163,37.66,1.03
Chaco,2020,4,44332,61200,23687,7997,137216,32.44,1.05
Chubut,2020,4,45703,39756,3040,23363,111862,7.38,1.0
Córdoba,2020,4,267396,439322,125620,52827,885165,35.12,1.05
Corrientes,2020,4,50102,61495,3146,5626,120369,25.45,1.07
Entre Ríos,2020,4,85683,113670,15653,20206,235212,24.05,1.07
Formosa,2020,4,21264,10789,2432,15341,49826,19.7,1.08
Jujuy,2020,4,32850,52815,15639,1077,102381,25.2,1.15
La Pampa,2020,4,9009,58945,15432,12194,95580,9.88,0.92
La Rioja,2020,4,17513,34984,1,250,52748,12.53,1.03
Mendoza,2020,4,91842,68364,36083,18331,214620,11.09,1.09
Misiones,2020,4,49462,79855,6589,4359,140265,24.95,1.03
Neuquén,2020,4,30468,70614,13732,17689,132503,33.9,1.08
Río Negro,2020,4,48991,42022,17826,13994,122833,21.64,1.03
Salta,2020,4,56659,87817,30604,5858,180938,25.31,1.0
San Juan,2020,4,40072,7004,6599,10468,64143,6.41,1.06
San Luis,2020,4,8417,11767,27,63019,83230,21.25,1.02
Santa Cruz,2020,4,12347,19657,1041,4659,37704,7.49,1.13
Santa Fe,2020,4,287271,414746,62692,38712,803421,27.3,1.06
Santiago Del Estero,2020,4,26812,70522,570,5169,103073,11.28,1.04
Tierra Del Fuego,2020,4,12853,26439,6,0,39298,8.49,1.0
Tucumán,2020,4,149322,11150,68043,1834,230349,36.44,1.05
Buenos Aires,2020,3,653930,2384557,749087,94162,3881736,48.38,1.06
Capital Federal,2020,3,170375,1129573,39417,3936,1343301,63.8,1.06
Catamarca,2020,3,26868,3690,16857,261,47676,36.53,1.05
Chaco,2020,3,45745,58825,20675,6706,131951,30.8,1.1
Chubut,2020,3,45761,39386,2897,23216,111260,7.4,0.97
Córdoba,2020,3,276360,430771,102217,48368,857716,33.5,1.08
Corrientes,2020,3,50858,58681,2960,5513,118012,23.84,1.08
Entre Ríos,2020,3,87892,106950,13954,20379,229175,22.44,1.1
Formosa,2020,3,21790,10003,2000,15023,48816,18.28,1.08
Jujuy,2020,3,32611,57682,11112,952,102357,21.9,1.38
La Pampa,2020,3,9015,56845,14677,11893,92430,10.7,1.33
La Rioja,2020,3,17346,34984,1,250,52581,12.19,1.04
Mendoza,2020,3,91908,64672,32817,17523,206920,10.19,1.1
Misiones,2020,3,50195,77989,2572,3445,134201,24.14,1.07
Neuquén,2020,3,30222,70446,11043,16787,128498,31.45,1.08
Río Negro,2020,3,49530,40001,10381,13187,113099,21.08,1.07
Salta,2020,3,58216,84128,25445,5764,173553,25.27,1.12
San Juan,2020,3,40092,9223,5509,14023,68847,6.03,0.96
San Luis,2020,3,8401,10077,6,61828,80312,20.84,0.99
Santa Cruz,2020,3,12845,16098,1027,6938,36908,6.65,1.01
Santa Fe,2020,3,295051,405807,45721,37112,783691,25.69,1.07
Santiago Del Estero,2020,3,26419,70720,555,4185,101879,10.88,1.05
Tierra Del Fuego,2020,3,12854,26491,0,0,39345,8.51,1.05
Tucumán,2020,3,149605,11752,59949,1808,223114,34.84,1.07
Buenos Aires,2020,2,661272,2244277,723072,91736,3720357,45.66,1.01
Capital Federal,2020,2,178896,1106133,39482,3937,1328448,60.47,1.03
Catamarca,2020,2,26968,3641,14878,261,45748,34.94,1.2
Chaco,2020,2,46816,56017,17266,6452,126551,27.95,1.08
Chubut,2020,2,45761,38279,1324,17678,103042,7.61,1.07
Córdoba,2020,2,282858,415007,85818,44522,828205,30.98,1.05
Corrientes,2020,2,51248,55536,3144,3927,113855,22.16,1.08
Entre Ríos,2020,2,89391,99423,13954,20042,222810,20.45,1.07
Formosa,2020,2,21805,9353,1882,14723,47763,16.88,1.07
Jujuy,2020,2,32705,38938,5057,952,77652,15.86,1.12
La Pampa,2020,2,8551,54422,14232,11314,88519,8.03,1.1
La Rioja,2020,2,16885,34984,1,250,52120,11.67,1.47
Mendoza,2020,2,91904,62941,29613,15924,200382,9.27,1.1
Misiones,2020,2,50792,74497,2579,3319,131187,22.56,1.02
Neuquén,2020,2,30256,67990,11037,15755,125038,29.1,1.05
Río Negro,2020,2,49756,39650,10382,11331,111119,19.69,1.03
Salta,2020,2,59502,81740,24289,5123,170654,22.56,1.05
San Juan,2020,2,40092,8275,5509,7019,60895,6.31,1.04
San Luis,2020,2,8401,8357,6,60935,77699,21.02,1.0
Santa Cruz,2020,2,12845,16044,1027,6585,36501,6.59,1.03
Santa Fe,2020,2,299974,381679,46698,30487,758838,23.94,1.07
Santiago Del Estero,2020,2,25917,72074,355,3038,101384,10.41,1.04
Tierra Del Fuego,2020,2,12854,26025,0,0,38879,8.13,1.1
Tucumán,2020,2,150084,9833,55120,1357,216394,32.7,1.01
Buenos Aires,2020,1,673237,2210349,720688,85443,3689717,45.2,1.47
Capital Federal,2020,1,184494,1097635,38898,3911,1324938,58.72,1.33
Catamarca,2020,1,21945,3146,12056,261,37408,29.12,1.17
Chaco,2020,1,46356,54144,11958,6239,118697,25.94,1.11
Chubut,2020,1,45763,27287,1324,16885,91259,7.12,1.02
Córdoba,2020,1,286168,406109,68512,41617,802406,29.39,1.12
Corrientes,2020,1,51126,53231,2172,2437,108966,20.55,1.07
Entre Ríos,2020,1,90368,95434,13245,18737,217784,19.03,1.12
Formosa,2020,1,21068,8887,1800,14510,46265,15.7,1.08
Jujuy,2020,1,32066,38938,3078,942,75024,14.14,1.09
La Pampa,2020,1,8553,53755,13821,11295,87424,7.29,1.12
La Rioja,2020,1,13076,34984,0,251,48311,7.96,1.0
Mendoza,2020,1,91955,50251,28059,12465,182730,8.44,1.08
Misiones,2020,1,51458,69452,1220,460,122590,22.16,1.09
Neuquén,2020,1,29305,65951,11031,14711,120998,27.77,1.07
Río Negro,2020,1,47756,38479,10381,11222,107838,19.06,1.11
Salta,2020,1,60426,75593,23025,4125,163169,21.44,1.12
San Juan,2020,1,40092,6448,5508,7082,59130,6.04,1.0
San Luis,2020,1,8301,7612,5,58301,74219,20.98,1.01
Santa Cruz,2020,1,12845,15766,1026,6817,36454,6.42,1.23
Santa Fe,2020,1,302366,383673,35123,30488,751650,22.42,1.09
Santiago Del Estero,2020,1,24695,70424,200,2779,98098,10.0,1.02
Tierra Del Fuego,2020,1,12854,25632,0,0,38486,7.41,1.02
Tucumán,2020,1,143184,10494,44687,1355,199720,32.25,1.08
Buenos Aires,2019,4,720011,2191672,669194,87111,3667988,30.77,1.2
Capital Federal,2019,4,196938,1093143,35534,3914,1329529,44.2,1.14
Catamarca,2019,4,22999,3318,9506,261,36084,24.88,2.68
Chaco,2019,4,48661,53602,8831,5229,116323,23.38,1.17
Chubut,2019,4,47045,26977,1324,15267,90613,6.99,1.0
Córdoba,2019,4,296872,410038,53335,37750,797995,26.16,1.13
Corrientes,2019,4,52525,51845,2002,2458,108830,19.27,1.15
Entre Ríos,2019,4,92981,99206,12875,18561,223623,17.02,1.16
Formosa,2019,4,21567,8684,1760,14531,46542,14.53,1.1
Jujuy,2019,4,32949,37604,873,814,72240,12.96,1.08
La Pampa,2019,4,15457,56854,4942,11341,88594,6.53,1.14
La Rioja,2019,4,13738,34984,0,251,48973,8.0,1.0
Mendoza,2019,4,96678,49711,24989,13672,185050,7.79,1.27
Misiones,2019,4,53116,69676,847,441,124080,20.31,1.13
Neuquén,2019,4,29826,60970,10549,14246,115591,26.02,1.1
Río Negro,2019,4,49747,37933,9658,11437,108775,17.19,1.08
Salta,2019,4,63272,76062,21865,3040,164239,19.08,1.29
San Juan,2019,4,41360,6338,4931,7241,59870,6.04,1.0
San Luis,2019,4,8569,8027,6,55266,71868,20.69,1.05
Santa Cruz,2019,4,13264,15899,1036,6800,36999,5.21,1.04
Santa Fe,2019,4,312072,382254,27464,26978,748768,20.55,1.13
Santiago Del Estero,2019,4,24682,71239,200,2810,98931,9.79,1.04
Tierra Del Fuego,2019,4,13261,26821,0,0,40082,7.27,1.09
Tucumán,2019,4,146985,11012,39574,725,198296,29.88,1.55
Buenos Aires,2019,3,1277249,2144956,425386,85572,3933163,25.69,1.14
Capital Federal,2019,3,300288,1080973,24900,3895,1410056,38.72,1.28
Catamarca,2019,3,24349,5543,13,244,30149,9.29,1.05
Chaco,2019,3,50416,49156,8063,5224,112859,19.98,1.25
Chubut,2019,3,37298,27090,1917,15149,81454,6.97,1.15
Córdoba,2019,3,307780,399231,30064,37277,774352,23.19,1.26
Corrientes,2019,3,53344,50230,1888,2458,107920,16.7,1.21
Entre Ríos,2019,3,94947,96305,12888,18530,222670,14.7,1.21
Formosa,2019,3,21777,8359,1476,14292,45904,13.22,1.22
Jujuy,2019,3,33110,35742,274,812,69938,11.97,0.99
La Pampa,2019,3,19469,52941,4994,11462,88866,5.72,1.04
La Rioja,2019,3,14390,34984,11,251,49636,8.0,1.01
Mendoza,2019,3,148640,54312,6865,12975,222792,6.11,1.01
Misiones,2019,3,54493,65872,829,419,121613,17.94,1.24
Neuquén,2019,3,43347,60484,5560,13512,122903,23.75,1.38
Río Negro,2019,3,67478,37425,9739,10806,125448,15.98,1.37
Salta,2019,3,65799,74329,733,1580,142441,14.75,1.18
San Juan,2019,3,51670,7425,1227,7241,67563,6.04,0.99
San Luis,2019,3,13037,10561,350,62286,86234,19.73,0.99
Santa Cruz,2019,3,10663,17056,969,6544,35232,5.02,0.84
Santa Fe,2019,3,319396,377171,18690,24269,739526,18.17,1.21
Santiago Del Estero,2019,3,24556,71198,219,2759,98732,9.39,1.32
Tierra Del Fuego,2019,3,19790,26659,651,0,47100,6.69,1.06
Tucumán,2019,3,150918,12089,116,684,163807,19.31,1.04
Buenos Aires,2019,2,1284658,2079900,382971,75240,3822769,22.48,1.14
Capital Federal,2019,2,309937,1061358,36082,3962,1411339,30.34,1.23
Catamarca,2019,2,25682,5543,13,146,31384,8.81,1.11
Chaco,2019,2,50765,47448,4203,4727,107143,16.02,1.19
Chubut,2019,2,37313,26338,1917,14443,80011,6.05,1.03
Córdoba,2019,2,314768,388254,23023,33847,759892,18.44,1.17
Corrientes,2019,2,53835,47431,1701,2444,105411,13.83,1.15
Entre Ríos,2019,2,97081,91081,12764,17369,218295,12.19,1.14
Formosa,2019,2,21916,8686,1382,14292,46276,10.84,1.1
Jujuy,2019,2,33022,30742,274,812,64850,12.07,1.41
La Pampa,2019,2,19471,52101,4840,10789,87201,5.49,1.08
La Rioja,2019,2,15014,34984,11,251,50260,7.89,1.11
Mendoza,2019,2,148673,54027,6865,12748,222313,6.03,1.05
Misiones,2019,2,55373,64272,543,421,120609,14.5,1.16
Neuquén,2019,2,43420,59021,4983,12792,120216,17.23,1.09
Río Negro,2019,2,67841,36527,4037,10485,118890,11.63,1.11
Salta,2019,2,68827,62343,725,1210,133105,12.55,1.21
San Juan,2019,2,51680,7425,1174,2870,63149,6.12,1.05
San Luis,2019,2,11130,10298,347,57242,79017,19.88,2.28
Santa Cruz,2019,2,10665,10257,379,6514,27815,6.01,1.04
Santa Fe,2019,2,325420,355140,18236,21980,720776,15.07,1.16
Santiago Del Estero,2019,2,24393,64783,219,2759,92154,7.1,1.11
Tierra Del Fuego,2019,2,19790,25527,651,0,45968,6.34,1.0
Tucumán,2019,2,153121,12089,116,684,166010,18.53,1.12
Buenos Aires,2019,1,1304507,2020730,336362,64867,3726466,19.64,1.16
Capital Federal,2019,1,328246,1030814,32281,3978,1395319,24.72,1.08
Catamarca,2019,1,26912,4443,16,0,31371,7.96,0.99
Chaco,2019,1,53409,43555,1951,3628,102543,13.44,1.0
Chubut,2019,1,37302,23065,1923,14443,76733,5.89,0.97
Córdoba,2019,1,323272,363959,19902,24615,731748,15.73,0.99
Corrientes,2019,1,55842,43444,1615,1528,102429,12.05,0.99
Entre Ríos,2019,1,100999,90253,12723,16231,220206,10.66,0.97
Formosa,2019,1,22570,7878,940,13761,45149,9.83,1.0
Jujuy,2019,1,33248,12484,153,640,46525,8.56,1.0
La Pampa,2019,1,18832,57373,2891,9023,88119,5.06,1.17
La Rioja,2019,1,16367,34984,12,252,51615,7.09,1.0
Mendoza,2019,1,148524,40205,5662,10363,204754,5.74,1.0
Misiones,2019,1,54898,59214,465,426,115003,12.51,1.0
Neuquén,2019,1,40747,55634,3114,12510,112005,15.88,1.0
Río Negro,2019,1,68377,34124,3994,9736,116231,10.49,1.0
Salta,2019,1,74426,57933,647,1135,134141,10.38,0.99
San Juan,2019,1,51660,5838,808,2932,61238,5.84,1.02
San Luis,2019,1,11108,7784,378,53097,72367,8.71,0.99
Santa Cruz,2019,1,10659,4615,382,6514,22170,5.78,1.13
Santa Fe,2019,1,340038,340344,15621,23215,719218,12.99,0.99
Santiago Del Estero,2019,1,25337,61547,23,2847,89754,6.42,1.02
Tierra Del Fuego,2019,1,19789,23549,1623,0,44961,6.34,0.85
Tucumán,2019,1,159215,11670,118,678,171681,16.56,1.0
Buenos Aires,2018,4,1305576,1949637,296102,65477,3616792,16.94,1.01
Capital Federal,2018,4,328253,1019490,33042,3978,1384763,22.94,1.06
Catamarca,2018,4,26912,4443,16,0,31371,8.04,1.03
Chaco,2018,4,53409,43555,1940,3236,102140,13.49,1.05
Chubut,2018,4,37215,23065,952,14443,75675,6.09,1.0
Córdoba,2018,4,328854,355716,17675,21851,724096,15.81,1.07
Corrientes,2018,4,55842,42418,796,1515,100571,12.14,1.06
Entre Ríos,2018,4,101168,86198,4853,15472,207691,11.02,1.05
Formosa,2018,4,22619,7880,887,13761,45147,9.82,1.05
Jujuy,2018,4,33248,12484,153,640,46525,8.56,1.12
La Pampa,2018,4,18832,55337,2685,7772,84626,4.32,1.01
La Rioja,2018,4,16367,34984,12,252,51615,7.09,1.15
Mendoza,2018,4,148524,40205,5665,10363,204757,5.75,0.99
Misiones,2018,4,55500,53673,465,426,110064,12.5,1.0
Neuquén,2018,4,40747,55634,3115,12425,111921,15.89,1.08
Río Negro,2018,4,68377,34292,1299,8037,112005,10.49,1.04
Salta,2018,4,74295,57539,638,253,132725,10.46,1.13
San Juan,2018,4,51660,5838,806,2883,61187,5.72,1.0
San Luis,2018,4,11108,7784,378,53097,72367,8.82,1.0
Santa Cruz,2018,4,10659,4615,382,6378,22034,5.12,0.95
Santa Fe,2018,4,335519,322782,14387,18705,691393,13.18,1.07
Santiago Del Estero,2018,4,25339,61243,23,2649,89254,6.31,1.09
Tierra Del Fuego,2018,4,19789,23349,1623,0,44761,7.44,1.24
Tucumán,2018,4,159215,11670,119,686,171690,16.58,1.09
Buenos Aires,2018,3,1435856,1929273,156382,62318,3583829,16.78,1.14
Capital Federal,2018,3,334353,1009252,35694,3872,1383171,21.64,1.14
Catamarca,2018,3,27553,4443,15,1,32012,7.81,1.02
Chaco,2018,3,53927,42359,1990,2628,100904,12.89,1.03
Chubut,2018,3,58887,23065,1239,13817,97008,6.08,1.14
Córdoba,2018,3,337620,342401,15785,19213,715019,14.82,1.07
Corrientes,2018,3,56444,41300,212,1468,99424,11.49,1.06
Entre Ríos,2018,3,103318,83714,2403,15093,204528,10.52,1.03
Formosa,2018,3,22777,7589,817,13625,44808,9.32,1.04
Jujuy,2018,3,33363,10856,32,641,44892,7.67,1.22
La Pampa,2018,3,12415,54574,8437,7011,82437,4.28,1.04
La Rioja,2018,3,16587,34984,13,253,51837,6.16,1.1
Mendoza,2018,3,151033,40205,5744,8195,205177,5.79,0.98
Misiones,2018,3,56290,50793,512,391,107986,12.49,1.06
Neuquén,2018,3,46602,54129,998,12277,114006,14.67,1.1
Río Negro,2018,3,68590,33474,1252,5051,108367,10.06,1.06
Salta,2018,3,76600,53980,678,234,131492,9.27,1.04
San Juan,2018,3,54025,5838,826,2744,63433,5.74,0.98
San Luis,2018,3,11096,7784,368,52859,72107,8.81,1.49
Santa Cruz,2018,3,18606,4574,585,6238,30003,5.37,1.03
Santa Fe,2018,3,339126,312866,11749,16337,680078,12.36,1.05
Santiago Del Estero,2018,3,25805,58789,23,1662,86279,5.78,0.98
Tierra Del Fuego,2018,3,19365,22649,1502,1,43517,5.99,1.01
Tucumán,2018,3,161209,9280,110,252,170851,15.26,1.13
Buenos Aires,2018,2,1450203,1807868,143626,71256,3472953,14.68,1.03
Capital Federal,2018,2,342431,977916,35610,3908,1359865,18.94,1.07
Catamarca,2018,2,27444,4415,15,1,31875,7.69,0.94
Chaco,2018,2,54134,40750,562,1946,97392,12.5,1.0
Chubut,2018,2,58935,19591,1239,14070,93835,5.33,0.98
Córdoba,2018,2,345141,327636,13832,16355,702964,13.88,1.09
Corrientes,2018,2,56541,39715,201,1468,97925,10.88,0.98
Entre Ríos,2018,2,104811,80376,2405,12313,199905,10.19,1.03
Formosa,2018,2,23543,7311,18,13625,44497,8.97,0.81
Jujuy,2018,2,33571,10856,23,640,45090,6.29,0.93
La Pampa,2018,2,12416,53587,8420,7011,81434,4.1,1.02
La Rioja,2018,2,16663,34984,13,253,51913,5.59,0.95
Mendoza,2018,2,152938,36872,3084,6206,199100,5.88,1.0
Misiones,2018,2,57265,47923,512,391,106091,11.76,0.97
Neuquén,2018,2,46633,52855,998,12649,113135,13.37,1.12
Río Negro,2018,2,68667,32795,1252,4396,107110,9.51,1.06
Salta,2018,2,78386,53478,678,234,132776,8.93,0.97
San Juan,2018,2,54080,5068,826,3079,63053,5.85,1.0
San Luis,2018,2,11104,7666,368,16,19154,5.9,1.0
Santa Cruz,2018,2,18615,4474,585,6734,30408,5.19,1.0
Santa Fe,2018,2,337934,304349,11354,15801,669438,11.75,1.05
Santiago Del Estero,2018,2,26074,55935,23,1662,83694,5.91,0.95
Tierra Del Fuego,2018,2,19372,22756,531,1,42660,5.94,1.03
Tucumán,2018,2,160315,8965,110,252,169642,13.51,1.44
Buenos Aires,2018,1,1452061,1793884,133928,64379,3444252,14.2,1.09
Capital Federal,2018,1,349995,968483,35535,3164,1357177,17.75,1.17
Catamarca,2018,1,27300,4415,15,1,31731,8.2,1.05
Chaco,2018,1,54879,40157,383,388,95807,12.44,1.06
Chubut,2018,1,56375,19591,1194,14070,91230,5.42,1.0
Córdoba,2018,1,349342,326894,13178,13237,702651,12.79,1.1
Corrientes,2018,1,56937,35225,888,1334,94384,11.12,1.07
Entre Ríos,2018,1,106998,75751,3789,10776,197314,9.88,1.06
Formosa,2018,1,23556,7095,17,1603,32271,11.06,1.09
Jujuy,2018,1,33856,10456,23,28,44363,6.74,1.02
La Pampa,2018,1,10807,51389,8386,10556,81138,4.0,1.01
La Rioja,2018,1,16960,34984,13,253,52210,5.89,1.0
Mendoza,2018,1,152931,36872,3086,6206,199095,5.88,1.03
Misiones,2018,1,56311,46880,328,5,103524,12.08,1.07
Neuquén,2018,1,46714,55072,1000,12404,115190,11.96,1.12
Río Negro,2018,1,68769,31712,1251,4259,105991,8.98,1.12
Salta,2018,1,79936,51534,118,204,131792,9.19,1.09
San Juan,2018,1,54080,5068,826,2246,62220,5.85,1.0
San Luis,2018,1,11104,7594,368,16,19082,5.89,1.03
Santa Cruz,2018,1,18615,4474,1799,6734,31622,5.19,1.0
Santa Fe,2018,1,341997,300421,10674,11636,664728,11.17,1.08
Santiago Del Estero,2018,1,26788,54594,23,1432,82837,6.25,1.01
Tierra Del Fuego,2018,1,19372,9663,531,1,29567,5.77,1.11
Tucumán,2018,1,158611,8921,107,368,168007,9.36,1.03
Buenos Aires,2017,4,1241172,1718013,131181,60082,3150448,12.97,1.54
Capital Federal,2017,4,571363,961688,36277,3119,1572447,15.2,1.43
Catamarca,2017,4,27083,263,11,1,27358,7.78,1.48
Chaco,2017,4,55035,39690,389,380,95494,11.7,1.38
Chubut,2017,4,56378,15097,1187,14070,86732,5.41,1.55
Córdoba,2017,4,349710,324709,12778,12043,699240,11.64,1.28
Corrientes,2017,4,56786,34722,894,1334,93736,10.38,1.39
Entre Ríos,2017,4,107764,73692,1894,10267,193617,9.3,1.33
Formosa,2017,4,23410,6973,19,1603,32005,10.11,1.43
Jujuy,2017,4,33844,9626,20,28,43518,6.64,1.42
La Pampa,2017,4,10808,50495,8272,10569,80144,3.98,1.16
La Rioja,2017,4,16912,34984,14,253,52163,5.88,1.17
Mendoza,2017,4,152896,16114,3015,6206,178231,5.71,1.63
Misiones,2017,4,56271,47470,95,5,103841,11.32,1.34
Neuquén,2017,4,46739,54119,1017,12404,114279,10.72,1.31
Río Negro,2017,4,68690,30451,1250,4259,104650,8.05,1.47
Salta,2017,4,80705,50446,127,158,131436,8.45,1.38
San Juan,2017,4,54079,451,812,2246,57588,5.83,1.69
San Luis,2017,4,11104,1119,335,17,12575,5.73,1.64
Santa Cruz,2017,4,18614,1668,582,4638,25502,5.21,1.44
Santa Fe,2017,4,341680,293831,10602,10965,657078,10.3,1.32
Santiago Del Estero,2017,4,27313,40407,19,1025,68764,6.17,1.19
Tierra Del Fuego,2017,4,19372,6906,530,1,26809,5.2,1.49
Tucumán,2017,4,156583,5223,105,102,162013,9.11,1.43
Buenos Aires,2017,3,1288025,1571180,124920,35058,3019183,8.43,1.17
Capital Federal,2017,3,583249,941092,33481,2814,1560636,10.64,1.2
Catamarca,2017,3,26873,4411,12,1,31297,5.26,1.03
Chaco,2017,3,54888,37307,456,36,92687,8.48,1.1
Chubut,2017,3,56359,5645,1217,13503,76724,3.48,1.01
Córdoba,2017,3,344580,319360,10579,7137,681656,9.12,1.23
Corrientes,2017,3,56247,33993,947,1334,92521,7.45,1.1
Entre Ríos,2017,3,107774,69596,1786,6245,185401,6.99,1.11
Formosa,2017,3,22647,6816,428,2202,32093,7.07,1.14
Jujuy,2017,3,33796,9395,20,23,43234,4.69,1.03
La Pampa,2017,3,11378,49679,5153,11536,77746,3.44,1.04
La Rioja,2017,3,16638,34984,14,252,51888,5.01,0.91
Mendoza,2017,3,154036,33788,2772,29,190625,3.51,1.0
Misiones,2017,3,56472,43880,110,5,100467,8.43,1.11
Neuquén,2017,3,48001,52468,1044,11576,113089,8.17,1.22
Río Negro,2017,3,69301,30018,1106,3054,103479,5.49,1.16
Salta,2017,3,80782,50284,127,158,131351,6.13,1.06
San Juan,2017,3,54499,5068,816,1053,61436,3.45,0.99
San Luis,2017,3,11407,7576,347,26,19356,3.5,1.0
Santa Cruz,2017,3,19220,5487,1544,4552,30803,3.61,1.0
Santa Fe,2017,3,322953,290655,6338,4897,624843,7.79,1.14
Santiago Del Estero,2017,3,27733,54096,19,911,82759,5.18,1.02
Tierra Del Fuego,2017,3,21587,7012,622,1,29222,3.48,1.0
Tucumán,2017,3,154130,6431,106,40,160707,6.39,1.05
Buenos Aires,2017,2,1378549,1535037,119132,21555,3054273,7.2,1.08
Capital Federal,2017,2,615262,932466,38628,2819,1589175,8.84,1.06
Catamarca,2017,2,26401,255,14,1,26671,5.1,1.03
Chaco,2017,2,54449,35613,458,52,90572,7.69,1.05
Chubut,2017,2,43994,1067,916,13194,59171,3.45,1.0
Córdoba,2017,2,341748,303488,4451,6446,656133,7.42,1.09
Corrientes,2017,2,55262,33192,258,1354,90066,6.79,1.06
Entre Ríos,2017,2,108309,67650,254,6448,182661,6.29,1.06
Formosa,2017,2,22493,6410,17,1023,29943,6.18,1.08
Jujuy,2017,2,33742,8858,22,0,42622,4.54,1.03
La Pampa,2017,2,12754,48310,5194,6253,72511,3.32,1.03
La Rioja,2017,2,16244,0,15,2,16261,5.53,1.02
Mendoza,2017,2,153331,13030,2581,27,168969,3.51,1.0
Misiones,2017,2,56752,42925,103,5,99785,7.6,1.04
Neuquén,2017,2,51794,50283,1133,11545,114755,6.7,1.11
Río Negro,2017,2,67038,29147,961,3213,100359,4.74,1.07
Salta,2017,2,80184,27280,115,158,107737,5.76,1.08
San Juan,2017,2,48670,451,772,1073,50966,3.49,1.0
San Luis,2017,2,11432,1120,354,26,12932,3.5,1.0
Santa Cruz,2017,2,15311,2722,1365,4735,24133,3.6,1.0
Santa Fe,2017,2,329813,228102,3234,4958,566107,6.84,1.09
Santiago Del Estero,2017,2,28337,3900,19,911,33167,5.06,1.02
Tierra Del Fuego,2017,2,22636,6905,665,1,30207,3.48,1.0
Tucumán,2017,2,149013,5223,116,14,154366,6.09,1.04
Buenos Aires,2017,1,1559178,1465817,118839,21200,3165034,6.68,1.05
Capital Federal,2017,1,428801,918328,38259,2730,1388118,8.35,1.05
Catamarca,2017,1,26020,248,14,1,26283,4.97,1.02
Chaco,2017,1,54430,34277,252,52,89011,7.31,1.03
Chubut,2017,1,43994,999,916,13194,59103,3.44,1.01
Córdoba,2017,1,335673,293479,4871,5782,639805,6.8,1.05
Corrientes,2017,1,54993,31994,236,1354,88577,6.43,1.03
Entre Ríos,2017,1,108509,65095,230,6448,180282,5.95,1.02
Formosa,2017,1,22438,6215,16,1023,29692,5.74,1.02
Jujuy,2017,1,33869,9278,22,0,43169,4.39,1.02
La Pampa,2017,1,12754,47195,5194,6253,71396,3.22,1.01
La Rioja,2017,1,16180,0,15,2,16197,5.43,1.02
Mendoza,2017,1,153326,13030,2581,27,168964,3.51,1.0
Misiones,2017,1,57363,40142,101,5,97611,7.34,1.03
Neuquén,2017,1,51771,48109,1124,11665,112669,6.03,1.06
Río Negro,2017,1,67075,28785,954,3213,100027,4.45,1.02
Salta,2017,1,79837,26845,114,158,106954,5.34,1.02
San Juan,2017,1,48670,451,772,1073,50966,3.49,1.0
San Luis,2017,1,11432,1120,354,26,12932,3.5,1.0
Santa Cruz,2017,1,15502,2722,1272,4733,24229,3.59,1.01
Santa Fe,2017,1,327458,226094,3210,4948,561710,6.28,1.04
Santiago Del Estero,2017,1,29616,3900,19,911,34446,4.95,1.02
Tierra Del Fuego,2017,1,22636,6905,665,1,30207,3.48,1.0
Tucumán,2017,1,147373,5223,116,14,152726,5.88,1.03
Buenos Aires,2016,4,1563542,1414676,118747,21394,3118359,6.35,1.07
Capital Federal,2016,4,434835,914952,38161,2583,1390531,7.96,1.08
Catamarca,2016,4,26735,250,14,1,27000,4.89,1.03
Chaco,2016,4,54974,33534,248,52,88808,7.08,1.05
Chubut,2016,4,43994,955,916,13107,58972,3.41,1.02
Córdoba,2016,4,337368,289344,3368,5686,635766,6.47,1.07
Corrientes,2016,4,54981,31497,233,1354,88065,6.24,1.05
Entre Ríos,2016,4,109359,64141,226,6448,180174,5.81,1.04
Formosa,2016,4,22400,6061,16,1023,29500,5.63,1.04
Jujuy,2016,4,33838,8731,22,0,42591,4.32,1.02
La Pampa,2016,4,12754,47245,5054,6253,71306,3.19,1.02
La Rioja,2016,4,16270,0,16,2,16288,5.34,1.05
Mendoza,2016,4,153320,13030,2579,27,168956,3.51,1.0
Misiones,2016,4,57983,39294,100,5,97382,7.11,1.05
Neuquén,2016,4,51742,46389,1124,11910,111165,5.68,1.07
Río Negro,2016,4,67057,28474,954,3274,99759,4.37,1.05
Salta,2016,4,79389,26657,110,158,106314,5.22,1.03
San Juan,2016,4,48670,451,772,1121,51014,3.49,1.0
San Luis,2016,4,11432,1120,354,26,12932,3.5,1.0
Santa Cruz,2016,4,15607,2722,1055,4823,24207,3.56,1.01
Santa Fe,2016,4,326721,225792,3201,4946,560660,6.04,1.06
Santiago Del Estero,2016,4,30192,3900,19,911,35022,4.87,1.04
Tierra Del Fuego,2016,4,22636,6905,665,1,30207,3.48,1.0
Tucumán,2016,4,146995,4482,116,14,151607,5.73,1.03
Buenos Aires,2016,3,1574216,1355770,113463,18867,3062316,5.91,1.09
Capital Federal,2016,3,447726,905105,36796,2514,1392141,7.38,1.12
Catamarca,2016,3,26689,248,14,1,26952,4.73,1.08
Chaco,2016,3,56251,32730,232,2,89215,6.72,1.07
Chubut,2016,3,43987,935,916,13364,59202,3.34,1.0
Córdoba,2016,3,348481,285480,2540,5695,642196,6.07,1.1
Corrientes,2016,3,55934,30813,217,1354,88318,5.96,1.06
Entre Ríos,2016,3,112588,61850,206,6441,181085,5.59,1.09
Formosa,2016,3,21800,5905,9,0,27714,5.42,1.06
Jujuy,2016,3,34250,8236,22,0,42508,4.22,1.1
La Pampa,2016,3,12751,45952,4910,6236,69849,3.14,1.0
La Rioja,2016,3,16891,0,15,2,16908,5.08,1.06
Mendoza,2016,3,153233,13030,2576,28,168867,3.51,1.0
Misiones,2016,3,59776,38130,79,5,97990,6.74,1.08
Neuquén,2016,3,51752,44739,1093,12402,109986,5.29,1.09
Río Negro,2016,3,67043,28496,942,3293,99774,4.16,1.05
Salta,2016,3,80866,26113,90,157,107226,5.05,1.06
San Juan,2016,3,48670,451,770,1174,51065,3.49,1.0
San Luis,2016,3,11432,1113,354,23,12922,3.5,1.0
Santa Cruz,2016,3,15570,2722,817,4978,24087,3.54,1.01
Santa Fe,2016,3,334911,223011,3037,4862,565821,5.68,1.11
Santiago Del Estero,2016,3,31730,3900,19,3,35652,4.67,1.08
Tierra Del Fuego,2016,3,22636,6276,665,1,29578,3.48,1.0
Tucumán,2016,3,147259,3850,116,53,151278,5.54,1.07
Buenos Aires,2016,2,1579448,1305949,113070,21163,3019630,5.42,1.09
Capital Federal,2016,2,450644,892209,36669,2390,1381912,6.58,1.09
Catamarca,2016,2,26262,245,14,1,26522,4.36,1.04
Chaco,2016,2,56112,31825,221,52,88210,6.3,1.05
Chubut,2016,2,43977,867,916,13293,59053,3.34,0.99
Córdoba,2016,2,348891,277615,1709,5610,633825,5.52,1.07
Corrientes,2016,2,55511,29845,203,1354,86913,5.6,1.04
Entre Ríos,2016,2,112809,58768,169,6434,178180,5.13,1.01
Formosa,2016,2,22101,5658,6,1023,28788,5.1,1.05
Jujuy,2016,2,33758,7374,22,0,41154,3.84,1.02
La Pampa,2016,2,12754,44654,4708,6225,68341,3.15,1.03
La Rioja,2016,2,16691,0,15,2,16708,4.77,1.03
Mendoza,2016,2,153321,13030,2576,29,168956,3.5,1.0
Misiones,2016,2,59573,36145,77,5,95800,6.23,1.04
Neuquén,2016,2,51742,42370,1088,12466,107666,4.87,1.1
Río Negro,2016,2,67031,28100,939,3300,99370,3.98,1.04
Salta,2016,2,79438,24719,85,151,104393,4.75,1.0
San Juan,2016,2,48670,451,770,1214,51105,3.49,1.0
San Luis,2016,2,11432,1063,354,30,12879,3.5,1.0
Santa Cruz,2016,2,15453,2722,396,4996,23567,3.5,1.01
Santa Fe,2016,2,336244,219088,2981,4744,563057,5.14,1.05
Santiago Del Estero,2016,2,32101,3900,19,911,36931,4.31,1.03
Tierra Del Fuego,2016,2,22636,5707,665,1,29009,3.48,1.0
Tucumán,2016,2,145486,2968,116,58,148628,5.2,1.04
Buenos Aires,2016,1,1583560,1200859,111231,21108,2916758,4.99,1.02
Capital Federal,2016,1,454425,832126,36332,2284,1325167,6.05,1.02
Catamarca,2016,1,26096,243,15,1,26355,4.2,1.02
Chaco,2016,1,56353,29994,211,52,86610,5.99,1.03
Chubut,2016,1,43967,834,916,13280,58997,3.38,1.03
Córdoba,2016,1,350884,252346,674,5636,609540,5.16,1.02
Corrientes,2016,1,55454,28491,192,1354,85491,5.37,1.02
Entre Ríos,2016,1,113101,54948,146,6425,174620,5.08,1.01
Formosa,2016,1,21852,5420,5,1023,28300,4.87,1.05
Jujuy,2016,1,33481,6751,22,0,40254,3.77,1.01
La Pampa,2016,1,12754,41881,4536,6209,65380,3.05,1.04
La Rioja,2016,1,16645,0,16,2,16663,4.62,1.02
Mendoza,2016,1,153299,13030,2576,34,168939,3.5,1.0
Misiones,2016,1,59538,33330,70,5,92943,6.0,1.02
Neuquén,2016,1,51702,36122,1085,12502,101411,4.42,1.01
Río Negro,2016,1,66894,27312,937,3341,98484,3.83,1.02
Salta,2016,1,78973,22741,73,132,101919,4.74,1.01
San Juan,2016,1,48670,451,770,1195,51086,3.49,1.0
San Luis,2016,1,11432,1042,354,27,12855,3.5,1.0
Santa Cruz,2016,1,15654,2723,396,5088,23861,3.48,1.0
Santa Fe,2016,1,338052,204816,3014,4686,550568,4.9,1.02
Santiago Del Estero,2016,1,32838,3900,19,911,37668,4.17,1.02
Tierra Del Fuego,2016,1,22636,4834,665,1,28136,3.48,1.0
Tucumán,2016,1,144233,2165,116,74,146588,5.0,1.02
Buenos Aires,2015,4,1586343,1223603,103269,20397,2933612,4.88,1.04
Capital Federal,2015,4,455427,879950,19818,2273,1357468,5.93,1.05
Catamarca,2015,4,26180,242,15,1,26438,4.12,1.06
Chaco,2015,4,56818,29456,186,52,86512,5.83,1.07
Chubut,2015,4,43968,811,916,13521,59216,3.28,1.0
Córdoba,2015,4,353530,266062,480,5613,625685,5.07,1.04
Corrientes,2015,4,55681,28178,177,1354,85390,5.26,1.04
Entre Ríos,2015,4,113983,53411,122,6427,173943,5.01,1.05
Formosa,2015,4,21734,5314,4,1023,28075,4.66,1.12
Jujuy,2015,4,32934,6933,22,0,39889,3.72,1.05
La Pampa,2015,4,12755,42705,4327,6205,65992,2.94,1.01
La Rioja,2015,4,16886,0,16,2,16904,4.52,1.06
Mendoza,2015,4,153293,13030,2572,38,168933,3.5,1.0
Misiones,2015,4,60252,32533,48,5,92838,5.9,1.05
Neuquén,2015,4,51680,38902,1048,12934,104564,4.36,1.03
Río Negro,2015,4,66851,27221,915,3407,98394,3.77,1.01
Salta,2015,4,78744,22446,47,129,101366,4.67,1.06
San Juan,2015,4,48670,451,770,1230,51121,3.48,1.0
San Luis,2015,4,11432,1025,354,30,12841,3.5,1.0
Santa Cruz,2015,4,15614,2723,396,5261,23994,3.48,1.0
Santa Fe,2015,4,339843,212911,2885,4596,560235,4.81,1.05
Santiago Del Estero,2015,4,33582,4365,19,1139,39105,4.09,1.05
Tierra Del Fuego,2015,4,22636,4301,665,1,27603,3.47,1.0
Tucumán,2015,4,144188,1653,116,88,146045,4.88,1.07
Buenos Aires,2015,3,1585467,1183894,113590,19989,2902940,4.7,1.05
Capital Federal,2015,3,454815,871262,30974,2229,1359280,5.66,1.07
Catamarca,2015,3,25801,242,15,1,26059,3.88,1.05
Chaco,2015,3,56282,28809,186,52,85329,5.47,1.05
Chubut,2015,3,43964,792,916,13408,59080,3.28,1.02
Córdoba,2015,3,351692,264055,1450,5412,622609,4.87,1.07
Corrientes,2015,3,55792,27604,176,1340,84912,5.06,1.04
Entre Ríos,2015,3,113909,51945,122,6261,172237,4.77,1.05
Formosa,2015,3,21573,5264,2,899,27738,4.17,1.11
Jujuy,2015,3,32598,6895,22,0,39515,3.53,1.04
La Pampa,2015,3,12755,41886,4078,6195,64914,2.91,1.02
La Rioja,2015,3,16725,0,16,2,16743,4.25,1.06
Mendoza,2015,3,153299,13030,2572,42,168943,3.5,1.0
Misiones,2015,3,59921,31635,46,5,91607,5.63,1.06
Neuquén,2015,3,47102,36620,1045,13051,97818,4.23,1.04
Río Negro,2015,3,66806,27130,917,3415,98268,3.74,1.02
Salta,2015,3,78064,21688,47,129,99928,4.42,1.05
San Juan,2015,3,48670,451,770,1231,51122,3.48,1.0
San Luis,2015,3,11432,1025,354,31,12842,3.5,1.0
Santa Cruz,2015,3,15540,2718,396,5226,23880,3.48,1.0
Santa Fe,2015,3,337042,209673,4169,4426,555310,4.56,1.06
Santiago Del Estero,2015,3,33886,4365,19,1097,39367,3.91,1.05
Tierra Del Fuego,2015,3,22636,8085,665,1,31387,3.48,1.0
Tucumán,2015,3,142925,1135,116,88,144264,4.57,1.06
Buenos Aires,2015,2,1581770,1141052,115660,19268,2857750,4.46,1.03
Capital Federal,2015,2,453178,858342,19786,2172,1333478,5.31,1.06
Catamarca,2015,2,25387,242,15,1,25645,3.68,1.06
Chaco,2015,2,55767,27809,179,52,83807,5.19,1.06
Chubut,2015,2,43949,762,916,13055,58682,3.22,1.0
Córdoba,2015,2,348130,255596,435,5199,609360,4.56,1.06
Corrientes,2015,2,55238,26553,157,1321,83269,4.85,1.05
Entre Ríos,2015,2,113378,49767,119,6031,169295,4.55,1.05
Formosa,2015,2,21097,5164,2,737,27000,3.76,1.11
Jujuy,2015,2,32183,5482,22,0,37687,3.41,1.05
La Pampa,2015,2,12756,40825,3719,6190,63490,2.86,1.01
La Rioja,2015,2,16463,0,16,2,16481,4.0,1.06
Mendoza,2015,2,153301,13030,2572,38,168941,3.5,1.0
Misiones,2015,2,59179,29283,37,5,88504,5.33,1.07
Neuquén,2015,2,47078,34183,1044,12781,95086,4.06,1.04
Río Negro,2015,2,66738,26268,916,3457,97379,3.67,1.02
Salta,2015,2,77214,20297,47,129,97687,4.22,1.05
San Juan,2015,2,48670,451,770,1189,51080,3.48,1.0
San Luis,2015,2,11432,1025,354,33,12844,3.5,1.0
Santa Cruz,2015,2,15343,2707,396,4917,23363,3.47,1.0
Santa Fe,2015,2,333117,204685,2877,4320,544999,4.3,1.06
Santiago Del Estero,2015,2,33873,4365,19,1091,39348,3.73,1.04
Tierra Del Fuego,2015,2,22636,7927,665,1,31229,3.48,1.01
Tucumán,2015,2,139944,479,116,88,140627,4.31,1.06
Buenos Aires,2015,1,1583135,1096836,134177,18754,2832902,4.32,1.03
Capital Federal,2015,1,454934,841743,19334,1994,1318005,5.0,1.05
Catamarca,2015,1,25033,241,16,1,25291,3.48,1.04
Chaco,2015,1,54952,26161,164,27,81304,4.9,1.23
Chubut,2015,1,45645,717,906,12540,59808,3.21,1.01
Córdoba,2015,1,343883,247564,415,4645,596507,4.3,1.05
Corrientes,2015,1,54649,25372,129,1319,81469,4.63,1.22
Entre Ríos,2015,1,112363,47411,108,5943,165825,4.35,1.14
Formosa,2015,1,21022,4951,1,670,26644,3.38,1.12
Jujuy,2015,1,31505,5048,22,0,36575,3.24,1.04
La Pampa,2015,1,13143,39571,3215,6164,62093,2.83,1.03
La Rioja,2015,1,16282,0,16,2,16300,3.78,1.06
Mendoza,2015,1,152433,13030,2542,29,168034,3.5,1.0
Misiones,2015,1,58262,26836,30,5,85133,4.97,1.23
Neuquén,2015,1,47518,32152,1024,12088,92782,3.91,1.02
Río Negro,2015,1,66274,25217,907,3473,95871,3.59,1.01
Salta,2015,1,76280,19781,47,129,96237,4.02,1.04
San Juan,2015,1,48441,451,755,1165,50812,3.48,1.0
San Luis,2015,1,11414,1025,351,30,12820,3.5,1.0
Santa Cruz,2015,1,16215,2700,392,4772,24079,3.47,1.04
Santa Fe,2015,1,328809,199037,2845,4239,534930,4.06,1.07
Santiago Del Estero,2015,1,33813,4365,19,1020,39217,3.57,1.03
Tierra Del Fuego,2015,1,22291,7924,657,1,30873,3.45,0.99
Tucumán,2015,1,137857,115,116,88,138176,4.07,1.05
Buenos Aires,2014,4,1575978,1070135,120528,17728,2784369,4.2,1.06
Capital Federal,2014,4,455785,840224,17155,1962,1315126,4.78,1.08
Catamarca,2014,4,25192,241,16,0,25449,3.34,1.14
Chaco,2014,4,55024,10918,31,0,65973,3.98,1.15
Chubut,2014,4,48539,697,891,12256,62383,3.17,1.0
Córdoba,2014,4,345157,240452,419,3918,589946,4.09,1.12
Corrientes,2014,4,54754,9526,40,1315,65635,3.81,1.12
Entre Ríos,2014,4,112291,23027,57,5178,140553,3.8,1.12
Formosa,2014,4,21245,4896,1,0,26142,3.02,1.14
Jujuy,2014,4,31349,4583,22,37,35991,3.13,1.07
La Pampa,2014,4,16043,34281,514,5894,56732,2.75,0.98
La Rioja,2014,4,16352,0,17,0,16369,3.58,1.15
Mendoza,2014,4,151797,13030,2534,31,167392,3.5,1.0
Misiones,2014,4,58435,18613,16,150,77214,4.03,1.13
Neuquén,2014,4,47721,31778,1014,11853,92366,3.85,1.03
Río Negro,2014,4,66307,23703,901,3819,94730,3.54,1.02
Salta,2014,4,76026,17289,48,6,93369,3.86,1.13
San Juan,2014,4,48653,451,740,1202,51046,3.48,1.0
San Luis,2014,4,11419,926,355,24,12724,3.5,1.0
Santa Cruz,2014,4,17553,448,388,4395,22784,3.33,1.01
Santa Fe,2014,4,335267,183009,3205,6282,527763,3.78,1.12
Santiago Del Estero,2014,4,34110,4231,19,920,39280,3.46,1.12
Tierra Del Fuego,2014,4,21948,3664,655,1,26268,3.47,1.0
Tucumán,2014,4,137093,97,116,13,137319,3.86,1.15
Buenos Aires,2014,3,1562533,1110628,124474,20049,2817684,3.97,1.03
Capital Federal,2014,3,450155,833402,17886,1995,1303438,4.44,1.04
Catamarca,2014,3,24380,244,15,0,24639,2.92,1.0
Chaco,2014,3,53321,10336,29,1,63687,3.46,1.01
Chubut,2014,3,49219,668,882,11853,62622,3.17,1.0
Córdoba,2014,3,340212,240334,444,4064,585054,3.66,1.03
Corrientes,2014,3,52957,9184,31,1312,63484,3.41,1.01
Entre Ríos,2014,3,108907,22440,48,5203,136598,3.4,1.03
Formosa,2014,3,21021,4836,0,0,25857,2.66,1.0
Jujuy,2014,3,30128,3541,22,37,33728,2.93,1.06
La Pampa,2014,3,16051,33940,538,11219,61748,2.82,1.05
La Rioja,2014,3,15864,0,14,1,15879,3.1,1.0
Mendoza,2014,3,150120,13030,2512,40,165702,3.5,1.0
Misiones,2014,3,56933,18373,4,3,75313,3.58,1.01
Neuquén,2014,3,54458,30964,1000,12858,99280,3.74,1.02
Río Negro,2014,3,65264,26590,888,3533,96275,3.48,1.01
Salta,2014,3,73828,18394,43,109,92374,3.41,1.01
San Juan,2014,3,48272,451,731,1199,50653,3.47,1.0
San Luis,2014,3,11303,925,355,25,12608,3.5,1.0
Santa Cruz,2014,3,17862,492,385,4273,23012,3.31,1.0
Santa Fe,2014,3,325577,183630,4407,6540,520154,3.38,1.02
Santiago Del Estero,2014,3,32820,3900,19,768,37507,3.1,1.01
Tierra Del Fuego,2014,3,21840,3469,650,1,25960,3.47,1.0
Tucumán,2014,3,131739,97,117,13,131966,3.35,1.0
Buenos Aires,2014,2,1568881,1025490,120008,17020,2731399,3.85,1.03
Capital Federal,2014,2,447637,828411,17729,1883,1295660,4.25,1.06
Catamarca,2014,2,24380,243,17,0,24640,2.92,1.04
Chaco,2014,2,53321,9870,30,0,63221,3.42,1.05
Chubut,2014,2,51070,649,866,10960,63545,3.16,0.99
Córdoba,2014,2,337825,234729,351,3673,576578,3.56,1.05
Corrientes,2014,2,52883,8680,31,1309,62903,3.37,1.05
Entre Ríos,2014,2,108900,21706,49,4795,135450,3.31,1.04
Formosa,2014,2,20894,4628,0,0,25522,2.65,1.03
Jujuy,2014,2,30128,4161,23,40,34352,2.77,1.03
La Pampa,2014,2,15957,32600,513,5869,54939,2.68,1.01
La Rioja,2014,2,15864,0,14,0,15878,3.1,1.05
Mendoza,2014,2,148979,13030,2480,36,164525,3.5,1.0
Misiones,2014,2,56933,17594,4,150,74681,3.54,1.04
Neuquén,2014,2,47767,29776,997,10765,89305,3.66,1.03
Río Negro,2014,2,64920,24944,876,3657,94397,3.43,1.02
Salta,2014,2,73841,17504,45,7,91397,3.39,1.03
San Juan,2014,2,48161,451,722,1139,50473,3.47,1.0
San Luis,2014,2,11306,925,354,22,12607,3.5,1.0
Santa Cruz,2014,2,18956,448,381,4118,23903,3.32,1.0
Santa Fe,2014,2,324101,178495,3085,6041,511722,3.31,1.05
Santiago Del Estero,2014,2,32820,4231,19,907,37977,3.07,1.04
Tierra Del Fuego,2014,2,21618,3008,648,1,25275,3.47,1.01
Tucumán,2014,2,131740,97,121,13,131971,3.35,1.04
Buenos Aires,2014,1,1567685,1000879,120960,16528,2706052,3.73,0.0
Capital Federal,2014,1,445569,820161,17767,1866,1285363,4.02,0.0
Catamarca,2014,1,24126,46,17,0,24189,2.8,0.0
Chaco,2014,1,52971,9497,30,0,62498,3.26,0.0
Chubut,2014,1,51066,539,866,10776,63247,3.18,0.0
Córdoba,2014,1,336841,225769,347,3585,566542,3.39,0.0
Corrientes,2014,1,52565,8279,31,1306,62181,3.22,0.0
Entre Ríos,2014,1,107883,21379,49,4887,134198,3.17,0.0
Formosa,2014,1,20774,4548,0,0,25322,2.57,0.0
Jujuy,2014,1,29765,4030,23,0,33818,2.69,0.0
La Pampa,2014,1,15826,31305,513,5848,53492,2.65,0.0
La Rioja,2014,1,15663,0,14,0,15677,2.96,0.0
Mendoza,2014,1,148970,12076,2480,37,163563,3.5,0.0
Misiones,2014,1,56597,17191,4,150,73942,3.4,0.0
Neuquén,2014,1,47790,28161,997,10381,87329,3.55,0.0
Río Negro,2014,1,64886,24156,876,3576,93494,3.35,0.0
Salta,2014,1,73131,17538,45,8,90722,3.3,0.0
San Juan,2014,1,48161,434,722,808,50125,3.47,0.0
San Luis,2014,1,11306,428,354,21,12109,3.5,0.0
Santa Cruz,2014,1,18927,100,381,4092,23500,3.32,0.0
Santa Fe,2014,1,322662,174296,3059,5951,505968,3.15,0.0
Santiago Del Estero,2014,1,32567,3598,19,915,37099,2.95,0.0
Tierra Del Fuego,2014,1,21618,2837,648,1,25104,3.45,0.0
Tucumán,2014,1,129717,83,121,13,129934,3.21,0.0
